11111111111111111111111111111
100000C1000C0CC01111100101001
10C1110101C00000110CCC0010001
10C00000001001001100000010011
100100000C1111001101000000C01
10C0000110010C001100C00000001
10000000001000000C000C0000001
11111000000001000000C00001001
1C011001110001010101000000C01
100000C0000C0CC01111111101001
10010E000000C00000C01000CCC01
1P010000C000000C00C01111C0CC1
100000C0000C0CC01111111111111
11111100000000000000010001111
11111111111111111111111111111
