11111111111111111111111111111
100P0E10000000000000000000001
10000010000CCCCCCCCCCCCCCCCC1
11111111111111111111111111111