1111111111111
100100C00C0C1
10P0011111001
100011E00C001
1111111111111