111111111111111111111111111
10C00C0111000C00C00CC1110E1
11000000CC00000001011000001
1011110000000000C0000CC0001
110000000000011111000001001
10CC00C11000000001100000111
10000001000000C0000C0011111
101111111000000011101100001
111000000000C000010CC011111
11000CCCC111110000000110001
100000000000000000000011011
1P0000000C0000CC00011111111
10C00C0111000C00C00CC111001
111111111111111111111111111